8 15 3 1
0 0 0 0 0 0 0 0 1 1 1 1 0 0 0
0 0 0 0 0 0 0 0 1 1 1 1 0 0 0
1 1 1 0 0 0 0 0 1 0 0 1 1 1 1
1 1 1 1 1 1 1 1 1 0 0 0 1 9 1
1 1 1 0 0 0 0 1 1 3 0 0 1 1 1
1 1 1 0 0 0 0 1 1 1 0 0 1 1 1
0 1 1 0 0 0 0 1 0 0 0 0 0 0 0
0 0 1 1 1 1 1 1 0 0 0 0 0 0 0
4 9 1 6 3