9 15 4 1
0 0 0 0 0 0 0 0 0 1 1 1 0 0 0
0 0 0 0 0 0 0 0 0 1 1 1 0 0 0
0 0 0 0 0 0 0 0 0 1 1 1 0 0 0
1 1 1 1 1 1 0 0 0 1 1 1 1 1 1
1 1 1 1 7 1 0 0 0 1 1 1 1 9 1
1 1 1 1 1 1 0 0 0 1 1 1 1 1 1
0 0 0 0 0 0 0 0 0 1 1 1 0 0 0
0 0 0 0 0 0 0 0 0 1 1 1 0 0 0
0 0 0 0 0 0 0 0 0 1 1 1 0 0 0
4 4 2 1 10 7 10