10 14 1 9
1 1 1 0 0 0 0 0 1 1 1 1 1 1
1 9 1 0 0 1 0 0 1 1 1 1 7 1
1 1 1 0 0 0 0 0 1 1 1 1 0 0
0 0 0 0 0 0 0 0 0 1 1 1 0 0
0 0 0 0 0 0 0 0 0 0 0 1 1 0
0 0 0 0 0 0 0 0 0 0 0 0 1 0
0 0 0 0 0 0 0 0 0 0 0 0 1 0
0 0 0 0 0 0 0 0 0 0 0 1 1 0
0 0 0 0 1 1 1 1 1 0 0 1 1 0
0 0 0 0 1 5 0 0 1 1 1 3 1 0
1 12 2 1 12 1 9
9 11 4 1 6 1 7 2 12 3 12
9 5 2 1 3 1 4
