10 15 8 1
0 0 0 0 0 0 0 1 1 1 0 0 1 1 1
0 0 0 0 1 1 1 1 1 1 0 0 3 1 1
1 1 0 0 1 0 0 1 1 1 0 0 1 1 1
1 1 1 1 1 0 0 0 5 0 0 0 0 0 0
1 1 0 0 0 0 0 0 0 0 0 0 0 0 0
0 1 0 0 0 0 0 7 0 0 0 0 0 0 0
0 1 0 0 0 0 0 1 0 0 0 0 0 0 0
1 1 1 0 0 0 1 1 1 0 0 4 1 1 0
1 1 1 1 1 1 1 1 1 1 1 1 9 1 0
1 1 1 0 0 0 1 1 1 0 0 4 1 1 0
5 7 2 8 1 1 13
7 11 2 8 9 8 10
9 11 2 8 9 8 10
3 8 4 1 5 1 6 1 10 1 11
1 12 4 1 5 1 6 2 2 2 3
