8 13 6 3
0 7 0 0 0 0 0 0 0 0 1 1 1
7 1 7 0 0 8 8 1 0 0 1 9 1
0 7 0 0 0 0 0 0 0 0 1 1 1
0 0 0 0 0 0 0 0 0 0 0 0 0
0 0 0 0 0 0 0 0 0 0 0 0 0
0 0 1 1 1 0 0 0 1 1 1 0 0
0 0 1 1 1 1 1 1 1 7 1 0 0
0 0 1 1 1 0 0 0 1 1 1 0 0
6 9 2 0 1 1 0
0 1 2 1 5 1 7
2 1 2 1 0 2 1
1 2 2 1 0 1 2
1 0 2 0 1 1 2
1 5 2 1 3 1 4
1 6 2 1 8 1 9
