10 15 1 1
1 1 1 0 0 0 0 0 0 0 0 0 0 0 0
1 1 1 1 1 1 1 1 1 0 0 0 1 1 1
1 1 1 0 0 0 0 0 1 1 1 1 1 9 1
1 1 1 0 0 0 0 0 0 0 0 0 3 3 1
1 1 1 0 0 0 0 0 0 0 0 0 0 0 0
1 1 1 0 0 0 0 0 0 0 0 0 0 0 0
1 1 1 0 0 0 0 1 1 1 1 1 3 0 0
1 1 1 1 1 1 1 1 0 0 0 1 1 0 0
1 5 1 0 0 0 0 0 0 0 0 1 1 0 0
1 1 1 0 0 0 0 0 0 0 0 1 3 0 0
8 1 1 7 8
6 12 0 0 1 2 7
9 12 0 1 7 8 1 1 9
3 12 0 1 6 6 0
3 13 0 0 1 6 6