9 15 3 2
0 0 0 0 0 0 0 6 0 0 0 0 0 0 0
1 1 4 1 0 0 0 1 0 0 0 0 0 0 0
1 1 1 1 1 0 0 1 0 0 0 0 0 0 0
1 4 1 1 1 1 1 1 0 0 1 1 0 0 1
1 1 1 1 1 0 0 0 1 0 0 0 1 0 0
1 1 4 1 0 0 0 0 1 0 0 0 1 0 0
1 0 0 0 0 0 0 0 6 0 0 1 1 1 0
1 0 0 0 0 0 0 0 0 0 1 1 9 1 0
1 0 0 3 0 0 0 0 0 0 1 1 1 1 0
3 1 2 3 8 3 9
1 2 4 3 12 3 13 8 1 8 2
5 2 4 3 12 3 13 8 1 8 2
0 7 2 3 8 3 9
6 8 4 3 12 3 13 8 1 8 2
8 3 1 4 5 0 0