10 15 0 1
0 1 1 1 1 1 1 1 1 1 5 1 1 1 1
0 0 0 0 0 1 1 0 0 0 0 0 0 1 1
0 0 0 0 0 1 1 0 0 0 0 0 0 1 1
0 0 0 0 0 0 0 0 0 0 0 0 0 1 1
0 0 0 0 0 0 0 0 0 0 0 0 0 1 1
1 1 1 0 0 1 1 0 0 1 4 1 1 1 1
1 9 1 0 0 1 1 0 0 0 0 0 0 0 0
1 1 1 0 0 1 1 0 0 0 0 0 0 0 0
0 1 1 0 0 1 1 0 0 0 0 0 0 0 0
0 1 1 1 1 1 1 1 1 1 6 1 1 1 0
0 10 2 5 7 5 8
5 10 2 9 2 9 3
9 10 2 9 2 9 3