10 15 2 8
0 0 0 0 0 0 0 0 0 0 0 0 1 1 1
0 0 1 1 1 1 1 1 1 1 0 0 1 1 1
0 0 1 1 1 0 0 4 1 1 0 0 1 1 1
0 0 1 1 1 0 0 1 1 1 0 0 0 0 0
0 0 1 4 1 0 0 7 1 4 0 0 0 0 0
0 0 1 1 1 0 0 1 1 1 0 0 0 0 0
1 1 1 1 0 0 0 1 1 1 0 0 5 1 1
1 5 0 0 0 0 0 0 0 0 0 0 1 1 1
0 0 0 0 0 0 0 0 0 0 0 0 1 9 1
0 0 0 0 0 0 0 0 0 0 0 0 1 1 1
2 7 2 1 5 1 6
4 9 2 1 5 1 6
4 7 2 1 13 7 13
6 12 2 6 10 6 11
4 3 2 1 5 1 6
7 1 2 1 10 1 11