10 15 3 1
0 0 0 0 0 0 0 0 1 1 0 0 0 0 0
0 0 0 0 0 0 0 1 1 1 0 0 0 0 0
1 1 0 0 1 1 1 1 1 1 0 0 0 0 0
1 1 1 1 1 1 0 0 1 0 0 0 0 0 0
1 1 1 1 0 0 0 0 1 0 0 0 1 1 1
0 1 1 0 0 0 0 0 3 1 1 1 1 9 1
0 0 1 0 0 0 0 0 3 1 0 0 1 1 1
0 0 1 1 1 0 0 0 1 1 0 0 0 0 0
0 0 0 1 1 1 0 0 1 1 0 0 0 0 0
0 0 0 0 1 1 1 1 1 1 0 0 0 0 0
5 8 1 9 3 0 0
6 8 1 7 5 0 0