10 14 3 1
0 0 0 0 0 1 1 0 0 0 0 1 1 1
0 0 0 1 1 1 1 1 1 0 0 1 9 1
1 1 1 1 1 1 4 1 1 1 1 1 1 1
1 1 1 1 4 0 0 1 1 1 1 1 0 0
1 1 1 0 0 0 0 0 0 1 1 1 0 0
0 1 0 0 0 0 0 0 0 0 1 0 0 0
0 1 0 0 0 0 0 0 0 0 1 0 0 0
0 1 0 0 0 0 0 0 0 1 1 0 0 0
0 1 1 0 0 0 0 0 0 1 1 0 0 0
0 0 3 0 0 0 0 0 0 3 0 0 0 0
3 4 2 7 2 3 12
2 6 2 7 2 3 12
9 9 1 7 2 0 0
9 2 1 3 12 0 0