10 15 7 4
0 1 1 1 0 0 0 0 0 0 0 0 1 1 1
0 1 3 1 0 0 0 0 0 0 0 0 1 5 1
0 1 1 1 0 0 0 1 1 1 1 1 1 1 1
0 1 1 1 0 0 0 1 9 1 0 0 1 1 5
1 0 0 0 1 0 0 1 1 1 0 0 0 0 1
5 0 0 0 1 0 0 2 2 2 0 0 0 0 1
1 0 0 1 1 1 2 2 2 2 2 1 1 1 1
0 0 0 1 1 1 2 2 2 2 2 1 7 1 0
0 0 0 1 1 1 2 2 2 2 2 1 1 1 0
0 0 0 1 1 1 1 1 0 0 0 0 0 0 0
7 12 2 7 12 2 2
1 13 1 9 8 0 2 6 1 6 2
3 14 0 3 2 10 2 11 6 14 0
5 0 0 2 6 1 6 2 1 3 0
1 2 0 0 1 3 4
