8 14 2 1
0 0 0 0 0 0 0 0 0 0 1 1 1 1
0 0 0 0 1 1 1 1 1 1 1 3 1 7
0 1 0 0 1 3 1 0 0 0 1 1 1 1
3 1 0 0 1 1 0 0 0 0 0 0 1 0
1 1 0 0 1 0 0 0 0 0 0 0 1 0
1 1 1 1 1 0 0 0 0 0 1 1 1 0
1 1 1 0 0 1 1 1 0 0 1 9 1 0
0 0 0 0 0 3 1 0 0 0 1 1 1 0
3 0 0 0 1 1 3
1 11 0 0 2 2 2 2 3
2 5 0 0 1 7 7
1 13 2 6 5 6 7
7 5 0 0 2 6 8 6 9