9 14 5 10
0 0 0 0 0 1 1 1 1 0 0 0 0 7
0 0 0 0 0 1 1 5 1 1 1 0 0 1
0 0 0 0 1 1 1 1 1 1 1 0 0 1
1 1 1 1 1 1 1 1 0 0 1 1 1 1
1 1 1 0 0 0 1 0 0 0 1 1 0 0
1 1 1 0 0 0 1 0 0 0 1 0 0 0
0 1 0 0 0 0 1 1 1 0 0 0 0 0
0 3 0 0 0 0 1 9 1 0 0 0 0 0
0 0 0 0 0 0 1 1 1 0 0 0 0 0
1 7 0 2 3 2 3 3 0
0 13 2 3 12 5 10
7 1 0 0 2 4 3 7 9