10 15 1 1
1 1 1 0 0 0 0 1 1 1 1 1 1 1 1
1 1 1 1 1 1 1 1 1 1 1 0 0 1 1
1 1 1 0 0 0 0 1 1 0 0 0 0 1 1
0 0 0 0 0 0 0 0 0 0 0 0 1 3 1
0 0 0 0 0 0 0 0 0 0 0 0 1 1 0
1 1 1 0 0 2 2 2 2 1 0 0 5 5 0
1 9 1 2 2 2 2 2 2 2 0 0 1 1 1
1 1 1 2 2 2 2 2 2 2 2 2 1 1 1
0 0 0 0 0 2 2 2 2 2 2 2 1 1 1
0 0 0 0 0 0 1 1 1 1 0 0 0 0 0
3 13 0 2 9 6 9 9 0
5 12 0 1 9 6 0
5 13 0 1 9 9 0