10 15 3 7
0 0 5 1 1 1 0 0 0 1 0 0 3 0 0
0 0 0 0 0 1 0 0 0 1 0 0 0 0 0
0 0 0 0 0 1 1 1 1 1 0 0 0 0 0
3 0 0 1 1 1 1 1 1 1 1 1 0 0 3
0 0 0 0 0 1 1 1 1 1 0 0 0 0 0
0 0 0 0 0 0 1 0 0 1 0 0 0 0 0
0 0 0 0 0 0 1 0 0 1 1 1 5 0 0
1 1 1 0 0 1 1 0 0 1 0 0 0 0 0
1 9 1 0 0 1 0 0 0 1 0 0 0 0 0
1 1 1 0 0 0 0 0 0 1 1 1 5 0 0
0 2 0 2 6 10 6 11 2 0 10 0 11
0 12 0 0 2 5 5 6 5
6 12 0 0 2 3 1 3 2
9 12 0 6 0 3 0 4 0 10 0 11 6 10 6 11 2 3 12 3 13
3 14 0 0 1 9 3
3 0 0 2 9 10 9 11 2 8 3 8 4