10 15 4 2
0 0 0 1 1 1 1 1 2 2 1 1 1 1 0
0 0 0 1 9 1 1 0 0 0 0 0 2 1 0
0 0 0 1 1 1 0 0 0 0 0 0 2 1 3
0 0 0 0 0 0 0 2 1 1 1 1 1 1 1
0 0 1 0 0 0 0 2 2 0 0 0 0 0 1
0 3 1 2 0 0 0 2 2 0 0 0 0 0 1
2 2 2 2 0 0 0 1 1 0 0 0 0 1 1
2 2 2 1 2 1 2 2 1 2 0 0 3 1 0
1 2 2 2 2 2 2 2 2 2 2 2 1 0 0
0 2 1 2 2 2 0 0 2 2 2 2 1 0 0
5 1 0 0 2 3 10 3 11
7 12 1 7 14 0 0
2 14 0 2 3 10 3 11 2 6 9 6 12
