10 15 3 1
0 0 0 0 0 1 1 5 1 1 1 0 0 0 0
0 0 0 0 0 1 1 1 1 1 1 0 0 0 0
1 1 1 0 0 5 1 1 5 1 1 1 1 1 0
1 1 1 1 1 1 1 1 1 5 5 1 1 5 0
0 0 0 0 0 1 1 5 1 1 5 1 1 1 0
0 0 0 0 0 1 1 1 1 1 1 5 1 1 0
1 1 1 0 0 1 1 1 1 1 1 5 1 1 1
1 9 1 1 1 1 5 1 0 0 1 1 1 5 3
1 1 1 0 0 1 1 1 0 0 0 1 1 1 1
1 1 1 0 0 0 0 0 0 0 0 0 1 1 1
2 5 0 2 7 3 7 4 0
0 7 0 2 7 3 7 4 0
4 7 0 2 7 3 7 4 0
7 6 0 2 7 3 7 4 0
2 8 0 2 7 3 7 4 0
3 9 0 2 7 3 7 4 0
3 10 0 2 7 3 7 4 0
4 10 0 2 7 3 7 4 0
5 11 0 2 7 3 7 4 0
6 11 0 2 7 3 7 4 0
3 13 0 2 7 3 7 4 0
7 13 0 2 7 3 7 4 0
7 14 0 0 1 1 11